{
  "code": "maze4",
  "name": "Advanced Maze",
  "difficulty": "Advanced",
  "grid": [
    ["S", " ", "X", "X", " ", " ", " ", " "],
    ["X", " ", "X", " ", "X", "X", "X", " "],
    [" ", " ", "X", " ", "X", " ", " ", " "],
    ["X", " ", " ", " ", "X", " ", "X", "X"],
    ["X", " ", "X", "X", "X", " ", "X", " "],
    [" ", " ", " ", " ", " ", " ", "X", " "],
    ["X", "X", "X", "X", "X", " ", " ", " "],
    [" ", " ", " ", " ", " ", " ", " ", "E"]
  ]
}