{
    "code": "maze4",
    "name": "Advanced Maze",
    "difficulty": "Advanced",
    "grid": [
        ["P", "_", "X", "X", "_"],
        ["X", "_", "X", "_", "X"],
        ["_", "_", "X", "_", "X"],
        ["X", "_", "_", "_", "X"],
        ["X", "_", "X", "X", "X"],
        ["_", "Z", "_", "_", "_"],
        ["X", "X", "X", "X", "X"],
        ["_", "_", "_", "_", "_"]
    ]
}